

MMMMMMMMMMMMMMMMMMMMMMMMM
M1MOMBMOMOMOMOMBMOMOMOMBM
MOOOBBOOOOOOOBBBBOOOBOOOM
MBMOMOMOMOMOMBMOMBMOMOMOM
MBBOOOBBBBOOOBOOBBOOOBBBM
MOMOMOMOMOMOMBMOBOMOMOMOM
MOOOBOOOOOOOBBOOOOOBOBBBM
MOMOMOMOMOMBMBMBMOMOMOMBM
MOOBBOOOOBBBBOOOOOBBOOOOM
MOMOMBMBMOMBMOMOMBMOMOMOM
MOBOOBOBOBBOOOOBOOOBBOOOM
MOMOMBMOMBMOMBMOMOMOMOMBM
MOOOOBOOBOOOOBBBOOOOOOBBM
MOMOMOMOMOMBMOMOMBMOMOMOM
MOOBBBOBOOBOOOOOOBBOOOOOM
MOMBMOMOMOMBMOMBMBMOMOM2M
MMMMMMMMMMMMMMMMMMMMMMMMM